wwwwwww wwwwwww
w w   w   w   w
w w w www w w w
w   w       w w
w wwww wwwwww w
w    w    w   w
wwww wwww www w
w       w   w w
w www w www www
w w   w       w
w wwwww www w w
w w       w w w
w w w www www w
w   w   w   w w
wwwwwwwgwwwwwww